###############################
#  #         ####    $#       #
#  #$   $    #    #   # ###   #
#  # #####   #  ###   #  $#   #
#  #   #     #  #     #  #    #
#  #   #$    #  #     #  #    #
#  ## ####   #  # #####  #  * #
#        #      #        #    #
###############################
