###############################
#  #         ####    $#       #
#  #$   $    #    #   # ###   #
#  # #####   #  ###   #  $#   #
#  #   #     #  #     #  #    #
#  #   #$   ##  #     #  #    #
#  ## ####   #  # #####  #  * #
#        #      #        #    #
###############################
