############################
# ...........##............#
#. ###.#####.##.#####.####.#
#.####.#####.##.#####.####.#
#..........................#
#.####.##.########.##.####.#
#......##....##....##......#
######.## ######## ##.######
     #.##          ##.#     
     #.## #=####=# ##.#     
######.## # OOOO # ##.######
#     .   # OOOO #   .     #
######.## # OOOO # ##.######
     #.## #=####=# ##.#     
     #.##    $     ##.#     
######.## ###  ### ##.######
#.........#......#.........#
#.####.##############.####.#
#...##................##...#
#.#.##.## ########.##.##.#.#
#......##....##....##......#
#.##########.##.#########*.# <--
#............##............#
############################