########################################################
# ...........##............## ...........##............#
#. ###.#####.##.#####.####.##. ###.#####.##.#####.###*.# <=
#.####.#####.##.#####.####.##.####.#####.##.#####.####.#
#..........................##..........................#
#.####.##.########.##.####.##.####.##.########.##.####.#
#......##....##....##......##......##....##....##......#
######.## ######## ##.############.## ######## ##.######
     #.##          ##.#          #.##          ##.#     
     #.## #=####=# ##.#          #.## #=####=# ##.#     
######.## # OOOO # ##.############.## # OOOO # ##.######
#     .   # OOOO #   .     ##     .   # OOOO #   .     #
######.## # OOOO # ##.############.## # OOOO # ##.######
     #.## #=####=# ##.#          #.## #=####=# ##.#     
     #.##    $     ##.#          #.##    $     ##.#     
######.## ###  ### ##.############.## ###  ### ##.######
#.........#......#.........##.........#......#.........#
#.####.##############.####.##.####.##############.####.#
#...##................##...##...##................##...#
#.#.##.## ########.##.##.#.##.#.##.## ########.##.##.#.#
#......##....##....##......##......##....##....##......#
#.##########.##.##########.##.##########.##.##########.#
#............##............  ............##............#
########################################################