############################
#............##............#
#.####.#####.##.#####.####.#
#P####.#####.##.#####.####P#
#..........................#
#.####.##.########.##.####.#
#......##....##....##......#
######.##### ## #####.######
     #.##          ##.#     
     #.## #-####-# ##.#     
######.## #      # ##.######
#     .   #      #   .     #
######.## #      # ##.######
     #.## #-####-# ##.#     
     #.##    $     ##.#     
######.## ######## ##.######
#............##............#
#.####.#####.##.#####.####.#
#P..##................##..P#
###.##.##.########.##.##.###
#......##....##....##......#
#.##########.##.##########.#
#............##............#
############################